 __       _    --------------                                                
|__)_  _ (_   | NetWars Room |                                               
| \(_)(_)|    |              |                                               
              |            * |                                               
               --------------                                                
                                                                             
__  __                              __  __                                   
 _)|_                                _)|_          -------                   
/__|        Tracks                  __)|          |Balcony|                  
            1 2 3 4 5 6 7                          -------                   
 -------    -------------                             |                      
|Speaker|--| Talks Lobby |                        --------                   
|Unprep |  |             |                       |Santa's |                  
 -------    ------       |                       |Office  |                  
                  |      |                        --    --                   
                  |     *|                          |  |                     
                   ------                           |   ---                  
                                                    |    * |                 
    __                                               ------                  
 /||_                                                                        
  ||                                          __ __           --------       
  --------------------------              /| |_ |_           |Wrapping|      
 |        Courtyard         |              |.__)|            |  Room  |      
  --------------------------                                  --------       
    |                    |                                       |           
 ------    --------    ------                          ---    --------       
|Dining|--|Kitchen |--|Great |                            |--|Workshop|      
|      |   --------   |      |                            |  |        |      
| Room |--|      * |--| Room |                            |  |        |      
|      |  |Entryway|  |      |                            |  |        |      
 ------    --------    ------                             |  |        |      
               |                                             | *      |      
           ----------                                         --------       
          |Front Lawn|       NOTE: * denotes Santavator                      
           ----------                                                        